8 8
4 11 6 2 2 10 10 3
5 6 1 12 0 2 3 5
4 8 8 2 1 5 12 1
5 6 10 8 1 4 2 1
13 4 2 2 9 4 8 1
4 1 4 0 3 4 3 13
12 1 4 8 1 12 1 6
14 8 8 15 4 3 4 1